1111111111
1PC00CC101
1000110CE1
1111111111