1111111111
1P0000C101
1000110E11
1111111111