1111111111
1PC00CC101
1E00110C01
1111111111