1111111111111111111111111111111111111111111111111111111111111111111111111111111111111111111111111111
1P0000000000000000000000000000000000000000000000CC110000000000000C1000000000000000000000000000000001
10000000000000000000000000000000000000000000000011000000000000000100000000000000001000000000000000E1
1000000000000000000000000000000000000000000000000000000000000000000000000000000000100000000000000001
1000000000000000000000000000000000000000000000000000000000000000000000000000000000100000000000000001
1000000000000000000000000000000000000000000000000000000000000000000000000000000000100000000000000001
1000000000000000000000000000000000000000000000000000000000000000000000000000000000100000000000000001
1000000000000000000000000000000000000000000000000000000000000000000000000000000000100000000000000001
1000000000000000000000000000000000000000000000000000000000000000000000000000000000100000000000000001
1000000000000000000000000000000000000000000000000000000000000000000000000000000000100000000000000001
1000000000000000000000000000000000000000000000000000000000000000000000000000000000100000000000000001
1000000000000000000000000000000000000000000000000000000000000000000000000000000000100000000000000001
1000000000000000000000000000000000000000000000000000000000000000000000000000000000100000000000000001
1000000000000000000000000000000000000000000000000000000000000000000000000000000000100000000000000001
1000000000000000000000000000000000000000000000000000000000000000000000000000000000100000000000000001
1000000000000000000000000000000000000000000000000000000000000000000000000000000000100000000000000001
1000000000000000000000000000000000000000000000000000000000000000000000000000000000100000000000000001
1000000000000000000000000000000000000000000000000000000000000000000000000000000000100000000000000001
1000000000000000000000000000000000000000000000000000000000000000000000000000000000100000000000000001
1000000000000000000000000000000000000000000000000000000000000000000000000000000000100000000000000001
1000000000000000000000000000000000000000000000000000000000000000000000000000000000100000000000000001
1000000000000000000000000000000000000000000000000000000000000000000000000000000000100000000000000001
1000000000000000000000000000000000000000000000000000000000000000000000000000000000100000000000000001
1000000000000000000000000000000000000000000000000000000000000000000000000000000000100000000000000001
1000000000000000000000000000000000000000000000000000000000000000000000000000000000100000000000000001
1000000000000000000000000000000000000000000000000000000000000000000000000000000000100000000000000001
1000000000000000000000000000000000000000000000000000000000000000000000000000000000100000000000000001
1000000000000000000000000000000000000000000000000000000000000000000000000000000000100000000000000001
1000000000000000000000000000000000000000000000000000000000000000000000000000000000100000000000000001
1000000000000000000000000000000000000000000000000000000000000000000000000000000000100000000000000001
1000000000000000000000000000000000000000000000000000000000000000000000000000000000100000000000000001
1000000000000000000000000000000000000000000000000000000000000000000000000000000000100000000000000001
1000000000000000000000000000000000000000000000000000000000000000000000000000000000100000000000000001
1000000000000000000000000000000000000000000000000000000000000000000000000000000000100000000000000001
1000000000000000000000000000000000000000000000000000000000000000000000000000000000100000000000000001
1000000000000000000000000000000000000000000000000000000000000000000000000000000000100000000000000001
1000000000000000000000000000000000000000000000000000000000000000000000000000000000100000000000000001
1000000000000000000000000000000000000000000000000000000000000000000000000000000000100000000000000001
1000000000000000000000000000000000000000000000000000000000000000000000000000000000100000000000000001
1000000000000000000000000000000000000000000000000000000000000000000000000000000000100000000000000001
1000000000000000000000000000000000000000000000000000000000000000000000000000000000100000000000000001
1000000000000000000000000000000000000000000000000000000000000000000000000000000000100000000000000001
1000000000000000000000000000000000000000000000000000000000000000000000000000000000100000000000000001
1000000000000000000000000000000000000000000000000000000000000000000000000000000000100000000000000001
1000000000000000000000000000000000000000000000000000000000000000000000000000000000100000000000000001
1000000000000000000000000000000000000000000000000000000000000000000000000000000000100000000000000001
1000000000000000000000000000000000000000000000000000000000000000000000000000000000100000000000000001
1000000000000000000000000000000000000000000000000000000000000000000000000000000000100000000000000001
1000000000000000000000000000000000000000000000000000000000000000000000000000000000100000000000000001
1000000000000000000000000000000000000000000000000000000000000000000000000000000000100000000000000001
1000000000000000000000000000000000000000000000000000000000000000000000000000000000100000000000000001
1000000000000000000000000000000000000000000000000000000000000000000000000000000000100000000000000001
1000000000000000000000000000000000000000000000000000000000000000000000000000000000100000000000000001
1111111111111111111111111111111111111111111111111111111111111111111111111111111111111111111111111111