11111111111111
1M0C000M00C001
1000PH00000001
100HHR00000001
1MC00H0M000M01
10000000000001
10000000000001
1000M0000000E1
11111111111111