11111111111111111111
1P000000000000000001
100000000M0000000001
1C000000000000000001
1000M0000M0000M00001
10000000000000000001
100000000M00000000M1
1000000000000000M0E1
11111111111111111111