111111111
1P0H000M1
1C00000E1
111111111