1111111111111111111
1P00000000000000M01
10111100011111111C1
1M1000000R0000000C1
11110000011111111E1
1C00000000000000001
1111111111111111111