1111111111111111111111111111
1000000000000M100C00000000M1
10PR000000M11110111100000001
11110001M000000000000C000001
1M0C00C100C00010000011100001
1000000M0000011100000H1000M1
1000000111000000000000100001
10000000100000R00000001000M1
10H000000000M11011000010E001
100000000000000M000C000M0M01
1111111111111111111111111111