111111111111111111111111111111111111111111111111111
100000000000000000000000000000000000000000000000001
10P000000000000000000000000000000000000000000000001
111100000000010000000000000000000000000000000000001
1M0000000000011000000000000000000000000000000000001
1000000000000M1000000000000000000000000000000000001
100C00000000011000000000000000000000000000000000001
100000000000000000000000000000000000000000000000001
100000000000000000000000000000000000000000000000001
100000000000000000000000000000000000000000000000001
100000000000000000000000000000000000000000000000001
100000000000000000000000000000000000000000000000001
100000000000000000000000000000000000000000000000001
1000000000000000000000000000000000000000000000E0001
100000000000000000000000000000000000000000000000001
111111111111111111111111111111111111111111111111111