11111111
1P000001
100RR001
100CH001
100000E1
11111111