1111111111111111
1E0000000C0000P1
1111111111001111